== Dichterliebe, Op. 48 ==
// autor: Robert Schumann - Heinrich Heine
// youtube: https://youtu.be/ZEGbQb7gXzQ

## 1. Im wunderschönen Monat Mai 🎵
Im wunderschönen Monat Mai :: En el hermoso mes de mayo  
Als alle Knospen sprangen :: Cuando todos los brotes estallaban  
Da ist in meinem Herzen :: Entonces en mi corazón  
Die Liebe aufgegangen :: Brotó el amor.

Im wunderschönen Monat Mai :: En el hermoso mes de mayo  
Als alle Vögel sangen :: Cuando cantaban todos los pájaros  
Da hab’ ich ihr gestanden :: Entonces le confesé  
Mein Sehnen und Verlangen :: Mi anhelo y deseo.

## 2. Aus meinen Tränen sprießen 🎵
Aus meinen Tränen sprießen :: De mis lágrimas brotan  
Viel blühende Blumen hervor :: Muchas flores florecidas  
Und meine Seufzer werden :: Y mis suspiros se vuelven  
Ein Nachtigallenchor :: Un coro de ruiseñores.

Und wenn du mich lieb hast, Kindchen :: Y si me amas, niñita  
Schenk’ ich dir die Blumen all’ :: Te regalaré todas las flores  
Und vor deinem Fenster soll klingen :: Y ante tu ventana ha de sonar  
Das Lied der Nachtigall :: El canto del ruiseñor.

## 3. Die Rose, die Lilie, die Taube, die Sonne 🎵
Die Rose, die Lilie, die Taube, die Sonne :: La rosa, el lirio, la paloma, el sol  
Ich lieb’ sie alle nicht mehr :: Ya no amo a ninguna  
Ich liebe alleine die Kleine, die Feine :: Amo solo a la pequeña, la delicada  
Die Reine, die Eine, die Schöne :: La pura, la única, la hermosa.

## 4. Wenn ich in deine Augen seh’ 🎵
Wenn ich in deine Augen seh’ :: Cuando miro en tus ojos  
So schwindet all mein Leid und Weh :: Toda mi pena y dolor desaparece  
Doch wenn ich küsse deinen Mund :: Pero cuando beso tu boca  
So werd’ ich ganz und gar gesund :: Me vuelvo completamente sano.

Wenn ich mich lehn’ an deine Brust :: Cuando me recuesto en tu pecho  
Kommt’s über mich wie Himmelslust :: Me invade como un gozo celestial  
Doch wenn du sprichst: ich liebe dich! :: Pero cuando dices: te amo  
So muss ich weinen bitterlich :: Entonces lloro amargamente.

## 5. Ich will meine Seele tauchen 🎵
Ich will meine Seele tauchen :: Quiero sumergir mi alma  
In den Kelch der Lilie hinein :: En el cáliz del lirio  
Die Lilie soll klingend hauchen :: El lirio debe susurrar sonoro  
Ein Lied von der Liebsten mein :: Una canción sobre mi amada.

Das Lied soll schauern und beben :: La canción debe estremecerse y temblar  
Wie der Kuss von ihrem Mund :: Como el beso de su boca  
Den sie mir einst gegeben :: Que una vez me dio  
In wunderbar süßer Stund’ :: En una hora maravillosamente dulce.

## 6. Im Rhein, im heiligen Strome 🎵
Im Rhein, im heiligen Strome :: En el Rin, en el sagrado río  
Da spiegelt sich in den Wellen :: Se refleja en las olas  
Mit seinem großen Dome :: Con su gran catedral  
Das große, heilige Köln :: La gran y santa Colonia.

Im Dom da steht ein Bildnis :: En la catedral hay un retrato  
Auf goldnem Leder gemalt :: Pintado sobre cuero dorado  
In meines Lebens Wildnis :: En la soledad de mi vida  
Hat’s freundlich hineingestrahlt :: Ha brillado amablemente.

## 7. Ich grolle nicht 🎵
Ich grolle nicht, und wenn das Herz auch bricht :: No guardo rencor, aunque el corazón se rompa  
Ewig verlor’nes Lieb! :: Amor perdido para siempre  
Ich grolle nicht :: No guardo rencor  
Ich sah dich ja im Traume :: Te vi en un sueño  
Und sah die Nacht in deines Herzens Raume :: Y vi la noche en tu corazón  
Und sah die Schlang’, die dir am Herzen frisst :: Y vi la serpiente que devora tu corazón  
Ich sah, mein Lieb, wie sehr du elend bist :: Vi, amor mío, cuán miserable eres.

## 8. Und wüßten’s die Blumen 🎵
Und wüßten’s die Blumen, die kleinen :: Si lo supieran las flores pequeñas  
Wie tief verwundet mein Herz :: Qué herido está mi corazón  
Sie würden mit mir weinen :: Llorarían conmigo  
Zu heilen meinen Schmerz :: Para curar mi dolor.

Und wüßten’s die Nachtigallen :: Si lo supieran los ruiseñores  
Wie ich so traurig und krank :: Cuán triste y enfermo estoy  
Sie ließen fröhlich erschallen :: Harían sonar alegremente  
Erquickenden Gesang :: Su canto reconfortante.

Und wüßten sie mein Wehe :: Y si supieran mi pena  
Die goldenen Sternelein :: Las estrellitas doradas  
Sie kämen aus ihrer Höhe :: Bajarían de su altura  
Und sprächen Trost mir ein :: Y me consolarían.

## 9. Das ist ein Flöten und Geigen 🎵
Das ist ein Flöten und Geigen :: Eso es flauta y violín  
Trompeten schmettern darein :: Trompetas se mezclan con fuerza  
Da tanzen die Hochzeitsleute :: Allí bailan los novios  
Den fröhlichen Hochzeitreihn :: El alegre corro de bodas.

Und draußen, da weinet ein Mädchen :: Y fuera, una muchacha llora  
Das schaut mit nassem Blick :: Que mira con ojos mojados  
Auf die glücklichen Leute :: A la gente feliz  
— Ich geh’ nicht zurück :: No volveré atrás.

## 10. Hör’ ich das Liedchen klingen 🎵
Hör’ ich das Liedchen klingen :: Al oír sonar la canción  
Das einst die Liebste sang :: Que una vez cantó la amada  
So will mir die Brust zerspringen :: Quiero que el pecho me estalle  
So wild wird mir mein Gang :: Tan salvado se vuelve mi andar.

Ich schleiche dann zu der Tür hinaus :: Entonces me deslizo hacia la puerta  
Und höre die Vögel schlagen :: Y escucho a los pájaros cantar  
Und geh’ in den stillen Wald hinaus :: Y salgo al bosque silencioso  
Und weine bitterlich :: Y lloro amargamente.

## 11. Ein Jüngling liebt ein Mädchen 🎵
Ein Jüngling liebt ein Mädchen :: Un joven ama a una muchacha  
Die hat einen andern erwählt :: Que ha elegido a otro  
Der andre liebt eine andre :: El otro ama a otra  
Und hat sich mit dieser vermählt :: Y se ha casado con ella.

Das Mädchen nimmt aus Ärger :: La muchacha, por despecho  
Den ersten besten Mann :: Toma al primer hombre que ve  
Der ihr in den Weg gelaufen :: Que se cruzó en su camino  
Und heiratet ihn dann :: Y se casa con él.

Es ist eine alte Geschichte :: Es es una vieja historia  
Doch bleibt sie immer neu :: Pero siempre es nueva  
Und wem sie just passieret :: Y a quien le sucede  
Dem bricht das Herz entzwei :: Se le parte el corazón.

## 12. Am leuchtenden Sommermorgen 🎵
Am leuchtenden Sommermorgen :: En la luminosa mañana de verano  
Geh’ ich im Garten herum :: Camino por el jardín  
Es flüstern und sprechen die Blumen :: Las flores susurran y hablan  
Ich aber wandl’ allein :: Pero yo paseo solo.

## 13. Ich hab’ im Traum geweinet 🎵
Ich hab’ im Traum geweinet :: He llorado en sueños  
Mir träumte, du lägest im Grab :: Soñé que estabas en la tumba  
Ich wachte auf, und die Träne :: Me desperté, y la lágrima  
Floß noch von der Wange herab :: Aún corría por mi mejilla.

## 14. Allnächtlich im Traume 🎵
Allnächtlich im Traume seh’ ich dich :: Cada noche en sueños te veo  
Und sehe dich freundlich grüßen :: Y te veo saludar dulcemente  
Und laut aufweinen muß ich :: Y rompo en llanto  
Und erwachen bitterlich :: Y despierto amargamente.

## 15. Aus alten Märchen winkt es 🎵
Aus alten Märchen winkt es :: Desde los viejos cuentos me llama  
Hervor mit weißer Hand :: Con una blanca mano  
Dass ich den Ort gefunden :: Como si hubiera encontrado el lugar  
Wo ich mein Herz verband :: Donde curé mi corazón.

## 16. Die alten, bösen Lieder 🎵
Die alten, bösen Lieder :: Las viejas, malas canciones  
Die Träume bös’ und arg :: Los sueños malos y crueles  
Die laßt uns jetzt begraben :: Enterrémoslos ahora  
Holt einen großen Sarg :: Traed un gran ataúd.

Ich leg’ auch meine Liebe :: También pondré mi amor  
Und meinen Schmerz hinein :: Y mi dolor dentro de él  
Und seine große Klage :: Y su gran lamento  
In diesen Sarg von Blei :: En este ataúd de plomo.
